"a" = (/turf/space,/area)
"b" = (/turf/unsimulated/wall{tag = "icon-sandstone0"; icon_state = "sandstone0"},/area)
"c" = (/turf/unsimulated/wall{tag = "icon-sandstone12"; icon_state = "sandstone12"},/area)
"d" = (/turf/unsimulated/wall{tag = "icon-sandstone3"; icon_state = "sandstone3"},/area)
"e" = (/turf/unsimulated/beach/sand{density = 1; opacity = 1},/area/awaymission/beach)
"f" = (/obj/machinery/gateway{dir = 9},/turf/unsimulated/beach/sand,/area/awaymission/beach)
"g" = (/obj/machinery/gateway{dir = 1},/turf/unsimulated/beach/sand,/area/awaymission/beach)
"h" = (/obj/machinery/gateway{dir = 5},/turf/unsimulated/beach/sand,/area/awaymission/beach)
"i" = (/turf/unsimulated/beach/sand,/area/awaymission/beach)
"j" = (/obj/effect/overlay/palmtree_r,/turf/unsimulated/beach/sand,/area/awaymission/beach)
"k" = (/obj/machinery/gateway{dir = 8},/turf/unsimulated/beach/sand,/area/awaymission/beach)
"l" = (/obj/machinery/gateway/centeraway,/turf/unsimulated/beach/sand,/area/awaymission/beach)
"m" = (/obj/machinery/gateway{dir = 4},/turf/unsimulated/beach/sand,/area/awaymission/beach)
"n" = (/obj/effect/overlay/palmtree_l,/obj/effect/overlay/coconut,/turf/unsimulated/beach/sand,/area/awaymission/beach)
"o" = (/obj/machinery/gateway{dir = 10},/turf/unsimulated/beach/sand,/area/awaymission/beach)
"p" = (/obj/machinery/gateway,/turf/unsimulated/beach/sand,/area/awaymission/beach)
"q" = (/obj/machinery/gateway{dir = 6},/turf/unsimulated/beach/sand,/area/awaymission/beach)
"r" = (/turf/unsimulated/wall{tag = "icon-sandstone6"; icon_state = "sandstone6"},/area/awaymission/beach)
"s" = (/turf/unsimulated/wall{tag = "icon-sandstone12"; icon_state = "sandstone12"},/area/awaymission/beach)
"t" = (/turf/unsimulated/wall{tag = "icon-sandstone10"; icon_state = "sandstone10"},/area/awaymission/beach)
"u" = (/obj/structure/closet/athletic_mixed,/turf/unsimulated/beach/sand,/area/awaymission/beach)
"v" = (/obj/item/clothing/shoes/sandal,/obj/item/clothing/shoes/sandal,/obj/item/clothing/shoes/sandal,/obj/structure/closet/crate,/turf/unsimulated/beach/sand,/area/awaymission/beach)
"w" = (/turf/unsimulated/wall{tag = "icon-sandstone3"; icon_state = "sandstone3"},/area/awaymission/beach)
"x" = (/obj/structure/closet/gmcloset{icon_closed = "black"; icon_state = "black"; name = "formal wardrobe"},/turf/unsimulated/floor{tag = "icon-wood"; icon_state = "wood"},/area/awaymission/beach)
"y" = (/obj/structure/closet/secure_closet/bar,/turf/unsimulated/floor{tag = "icon-wood"; icon_state = "wood"},/area/awaymission/beach)
"z" = (/obj/structure/table/woodentable,/obj/item/weapon/book/manual/barman_recipes,/turf/unsimulated/floor{tag = "icon-wood"; icon_state = "wood"},/area/awaymission/beach)
"A" = (/obj/structure/table/woodentable,/obj/item/weapon/reagent_containers/food/drinks/shaker,/turf/unsimulated/floor{tag = "icon-wood"; icon_state = "wood"},/area/awaymission/beach)
"B" = (/obj/structure/table/woodentable,/turf/unsimulated/floor{tag = "icon-wood"; icon_state = "wood"},/area/awaymission/beach)
"C" = (/obj/structure/table/woodentable,/obj/item/clothing/glasses/sunglasses,/turf/unsimulated/floor{tag = "icon-wood"; icon_state = "wood"},/area/awaymission/beach)
"D" = (/obj/machinery/vending/boozeomat{emagged = 1},/turf/unsimulated/floor{tag = "icon-wood"; icon_state = "wood"},/area/awaymission/beach)
"E" = (/obj/machinery/vending/cigarette,/turf/unsimulated/floor{tag = "icon-wood"; icon_state = "wood"},/area/awaymission/beach)
"F" = (/obj/machinery/vending/cola,/turf/unsimulated/floor{tag = "icon-wood"; icon_state = "wood"},/area/awaymission/beach)
"G" = (/obj/machinery/vending/snack,/turf/unsimulated/floor{tag = "icon-wood"; icon_state = "wood"},/area/awaymission/beach)
"H" = (/turf/unsimulated/wall{tag = "icon-sandstone1"; icon_state = "sandstone1"},/area/awaymission/beach)
"I" = (/turf/unsimulated/floor{tag = "icon-wood"; icon_state = "wood"},/area/awaymission/beach)
"J" = (/obj/structure/mineral_door/wood{tag = "icon-wood"; icon_state = "wood"},/turf/unsimulated/floor{tag = "icon-wood"; icon_state = "wood"},/area/awaymission/beach)
"K" = (/obj/effect/overlay/palmtree_l,/turf/unsimulated/beach/sand,/area/awaymission/beach)
"L" = (/turf/unsimulated/wall{tag = "icon-sandstone0"; icon_state = "sandstone0"},/area/awaymission/beach)
"M" = (/obj/structure/table/woodentable,/obj/item/weapon/reagent_containers/food/drinks/beer,/turf/unsimulated/floor{tag = "icon-wood"; icon_state = "wood"},/area/awaymission/beach)
"N" = (/obj/item/weapon/beach_ball,/turf/unsimulated/beach/sand,/area/awaymission/beach)
"O" = (/obj/structure/stool,/turf/unsimulated/beach/sand,/area/awaymission/beach)
"P" = (/mob/living/simple_animal/crab,/turf/unsimulated/beach/sand,/area/awaymission/beach)
"Q" = (/obj/effect/overlay/coconut,/turf/unsimulated/beach/sand,/area/awaymission/beach)
"R" = (/mob/living/simple_animal/crab/Coffee,/turf/unsimulated/beach/sand,/area/awaymission/beach)
"S" = (/obj/structure/stool/bed/chair,/turf/unsimulated/beach/sand,/area/awaymission/beach)
"T" = (/turf/unsimulated/beach/coastline{density = 1; opacity = 1},/area/awaymission/beach)
"U" = (/turf/unsimulated/beach/coastline,/area/awaymission/beach)
"V" = (/turf/unsimulated/beach/water{density = 1; opacity = 1},/area/awaymission/beach)
"W" = (/turf/unsimulated/beach/water,/area/awaymission/beach)

(1,1,1) = {"
aaaaaaaaaaaaaaaaaaaaaaaaaaaaaaaaaaaaaaaaaaaaaaaaaaaaaaaaaaaaaaaaaaaaaa
aaaaaaaaaaaaaaaaaaaaaaaaaaaaaaaaaaaaaaaaaaaaaaaaaaaaaaaaaaaaaaaaaaaaaa
aaaaaaaaaaaaaaaaaaaaaaaaaaaaaaaaaaaaaaaaaaaaaaaaaaaaaaaaaaaaaaaaaaaaaa
aaaaaaaaaaaaaaaaaaaaaaaaaaaaaaaaaaaaaaaaaaaaaaaaaaaaaaaaaaaaaaaaaaaaaa
aaaaaaaaaaaaaaaaaaaaaaaaaaaaaaaaaaaaaaaaaaaaaaaaaaaaaaaaaaaaaaaaaaaaaa
aaaaaaaaaaaaaaaaaaaaaaaaaaaaaaaaaaaaaaaaaaaaaaaaaaaaaaaaaaaaaaaaaaaaaa
aaaaaaaaaaaaaaaaaaaaaaaaaaaaaaaaaaaaaaaaaaaaaaaaaaaaaaaaaaaaaaaaaaaaaa
aaaaaaaaaaaaaaaaaaaaaaaaaaaaaaaaaaaaaaaaaaaaaaaaaaaaaaaaaaaaaaaaaaaaaa
aaaaaaaaaaaaaaaaaaaaaaaaaaaaaaaaaaaaaaaaaaaaaaaaaaaaaaaaaaaaaaaaaaaaaa
aaaaaaaaaaaaaaaaaaaaaaaaaaaaaaaaaaaaaaaaaaaaaaaaaaaaaaaaaaaaaaaaaaaaaa
aaaaaaaaaaaaaaaaaaaaaaaaaaaaaaaaaaaaaaaaaaaaaaaaaaaaaaaaaaaaaaaaaaaaaa
aaaaaaaaaaaaaaaaaaaaaaaaaaaaaaaaaaaaaaaaaaaaaaaaaaaaaaaaaaaaaaaaaaaaaa
aaaaaaaaaaaaaaaaaaaaaaaaaaaaaaaaaaaaaaaaaaaaaaaaaaaaaaaaaaaaaaaaaaaaaa
aaaaaaaaaaaaaaaaaaaaaaaaaaaaaaaaaaaaaaaaaaaaaaaaaaaaaaaaaaaaaaaaaaaaaa
aaaaaaaaaaaaaaaaaaaaaaaaaaaaaaaaaaaaaaaaaaaaaaaaaaaaaaaaaaaaaaaaaaaaaa
aaaaaaaaaaaaaaaaaaaaaaaaaaaaaaaaaaaaaaaaaaaaaaaaaaaaaaaaaaaaaaaaaaaaaa
aaaaaaaaaaaaaaaaaaaaaaaaaaaaaaaaaaaaaaaaaaaaaaaaaaaaaaaaaaaaaaaaaaaaaa
aaaaaaaaaaaaaaaaaaaaaaaaaaaaaaaaaaaaaaaaaaaaaaaaaaaaaaaaaaaaaaaaaaaaaa
aaaaaaaaaaaaaaaaaaaaaaaaaaaaaaaaaaaaaaaaaaaaaaaaaaaaaaaaaaaaaaaaaaaaaa
aaaaaaaaaaaaaaaaaaaaaaaaaaaaaaaaaaaaaaaaaaaaaaaaaaaaaaaaaaaaaaaaaaaaaa
aaaaaaaaaaaaaaaaaaaaaaaaaaaaaaaaaaaaaaaaaaaaaaaaaaaaaaaaaaaaaaaaaaaaaa
aaaaaaaaaaaaaaaaaaaaaaaaaaaaaaaaaaaaaaaaaaaaaaaaaaaaaaaaaaaaaaaaaaaaaa
aaaaaaaaaaaaaaaaaaaaaaaaaaaaaaaaaaaaaaaaaaaaaaaaaaaaaaaaaaaaaaaaaaaaaa
aaaaaaaaaaaaaaaaaaaaaaaaaaaaaaaaaaaaaaaaaaaaaaaaaaaaaaaaaaaaaaaaaaaaaa
aaaaaaaaaaaaaaaaaaaaaaaaaaaaaaaaaaaaaaaaaaaaaaaaaaaaaaaaaaaaaaaaaaaaaa
aaaaaaaaaaaaaaaaaaaaaaaaaaaaaaaaaaaaaaaaaaaaaaaaaaaaaaaaaaaaaaaaaaaaaa
aaaaaaaaaaaaaaaaaaaaaaaaaaaaaaaaaaaaaaaaaaaaaaaaaaaaaaaaaaaaaaaaaaaaaa
aaaaaaaaaaaaaaaaaaaaaaaaaaaaaaaaaaaaaaaaaaaaaaaaaaaaaaaaaaaaaaaaaaaaaa
aaaaaaaaaaaaaaaaaaaaaaaaaaaaaaaaaaaaaaaaaaaaaaaaaaaaaaaaaaaaaaaaaaaaaa
aaaaaaaaaaaaabccccccccccccccccccccccccccccccccccccccccbaaaaaaaaaaaaaaa
aaaaaaaaaaaaadeeeeeeeeeeeeeeeeeeeeeeeeeeeeeeeeeeeeeeeedaaaaaaaaaaaaaaa
aaaaaaaaaaaaadefghiiiiiiiiiiiiiiiiiiiiiiiiiiiiiiiiijiedaaaaaaaaaaaaaaa
aaaaaaaaaaaaadeklmiiiiniiiiiiiiiiiiiiiiiiiiiiiiiiiiiiedaaaaaaaaaaaaaaa
aaaaaaaaaaaaadeopqiiiiiiiirsssssssssstiiuvuvuvuvuvuvuedaaaaaaaaaaaaaaa
aaaaaaaaaaaaadeiiiiiiiiiiiwxyzABCDEFGwiiiiiiiiiiiiiiiedaaaaaaaaaaaaaaa
aaaaaaaaaaaaadeiiiiiiiiiiiHIIIIIIIIIIwiiiiiiiiiiiiiiiedaaaaaaaaaaaaaaa
aaaaaaaaaaaaadeiiiiiiiiiiiJIIIIIIIIIIwiiiiiiiiiKiiiiiedaaaaaaaaaaaaaaa
aaaaaaaaaaaaadeijiiiiiiiiiLBMBBBBBBBBHiiiKiiNiiiiiiiiedaaaaaaaaaaaaaaa
aaaaaaaaaaaaadeiiiiiiiiiiiiOOOOOOOOOOiiiiiiiiiiiiiiiiedaaaaaaaaaaaaaaa
aaaaaaaaaaaaadeiiiiiiiiiiiiiiiiiiiiiiiiiiiiiiiiiiiiiiedaaaaaaaaaaaaaaa
aaaaaaaaaaaaadeiiPiiiiiiiiiiiiiiiiiiiiiiiiiiijiiiiiiiedaaaaaaaaaaaaaaa
aaaaaaaaaaaaadeiiiiiKQiiiiiiiiiiiiiiKiiiiiRiiiQiiiiijedaaaaaaaaaaaaaaa
aaaaaaaaaaaaadeiiNiiiiiiPiiSiSiSiSiSiSiiiiiiiiiiSiSiiedaaaaaaaaaaaaaaa
aaaaaaaaaaaaadeiiiiiiiiiiiiiiiiiiiiiiiiiiiiiiiiiiiiiiedaaaaaaaaaaaaaaa
aaaaaaaaaaaaadTUUUUUUUUUUUUUUUUUUUUUUUUUUUUUUUUUUUUUUTdaaaaaaaaaaaaaaa
aaaaaaaaaaaaadVWWWWWWWWWWWWWWWWWWWWWWWWWWWWWWWWWWWWWWVdaaaaaaaaaaaaaaa
aaaaaaaaaaaaadVWWWWWWWWWWWWWWWWWWWWWWWWWWWWWWWWWWWWWWVdaaaaaaaaaaaaaaa
aaaaaaaaaaaaadVWWWWWWWWWWWWWWWWWWWWWWWWWWWWWWWWWWWWWWVdaaaaaaaaaaaaaaa
aaaaaaaaaaaaadVWWWWWWWWWWWWWWWWWWWWWWWWWWWWWWWWWWWWWWVdaaaaaaaaaaaaaaa
aaaaaaaaaaaaadVWWWWWWWWWWWWWWWWWWWWWWWWWWWWWWWWWWWWWWVdaaaaaaaaaaaaaaa
aaaaaaaaaaaaadVWWWWWWWWWWWWWWWWWWWWWWWWWWWWWWWWWWWWWWVdaaaaaaaaaaaaaaa
aaaaaaaaaaaaadVWWWWWWWWWWWWWWWWWWWWWWWWWWWWWWWWWWWWWWVdaaaaaaaaaaaaaaa
aaaaaaaaaaaaadVWWWWWWWWWWWWWWWWWWWWWWWWWWWWWWWWWWWWWWVdaaaaaaaaaaaaaaa
aaaaaaaaaaaaadVWWWWWWWWWWWWWWWWWWWWWWWWWWWWWWWWWWWWWWVdaaaaaaaaaaaaaaa
aaaaaaaaaaaaadVVVVVVVVVVVVVVVVVVVVVVVVVVVVVVVVVVVVVVVVdaaaaaaaaaaaaaaa
aaaaaaaaaaaaabccccccccccccccccccccccccccccccccccccccccbaaaaaaaaaaaaaaa
aaaaaaaaaaaaaaaaaaaaaaaaaaaaaaaaaaaaaaaaaaaaaaaaaaaaaaaaaaaaaaaaaaaaaa
aaaaaaaaaaaaaaaaaaaaaaaaaaaaaaaaaaaaaaaaaaaaaaaaaaaaaaaaaaaaaaaaaaaaaa
aaaaaaaaaaaaaaaaaaaaaaaaaaaaaaaaaaaaaaaaaaaaaaaaaaaaaaaaaaaaaaaaaaaaaa
aaaaaaaaaaaaaaaaaaaaaaaaaaaaaaaaaaaaaaaaaaaaaaaaaaaaaaaaaaaaaaaaaaaaaa
aaaaaaaaaaaaaaaaaaaaaaaaaaaaaaaaaaaaaaaaaaaaaaaaaaaaaaaaaaaaaaaaaaaaaa
aaaaaaaaaaaaaaaaaaaaaaaaaaaaaaaaaaaaaaaaaaaaaaaaaaaaaaaaaaaaaaaaaaaaaa
aaaaaaaaaaaaaaaaaaaaaaaaaaaaaaaaaaaaaaaaaaaaaaaaaaaaaaaaaaaaaaaaaaaaaa
aaaaaaaaaaaaaaaaaaaaaaaaaaaaaaaaaaaaaaaaaaaaaaaaaaaaaaaaaaaaaaaaaaaaaa
aaaaaaaaaaaaaaaaaaaaaaaaaaaaaaaaaaaaaaaaaaaaaaaaaaaaaaaaaaaaaaaaaaaaaa
aaaaaaaaaaaaaaaaaaaaaaaaaaaaaaaaaaaaaaaaaaaaaaaaaaaaaaaaaaaaaaaaaaaaaa
aaaaaaaaaaaaaaaaaaaaaaaaaaaaaaaaaaaaaaaaaaaaaaaaaaaaaaaaaaaaaaaaaaaaaa
aaaaaaaaaaaaaaaaaaaaaaaaaaaaaaaaaaaaaaaaaaaaaaaaaaaaaaaaaaaaaaaaaaaaaa
aaaaaaaaaaaaaaaaaaaaaaaaaaaaaaaaaaaaaaaaaaaaaaaaaaaaaaaaaaaaaaaaaaaaaa
aaaaaaaaaaaaaaaaaaaaaaaaaaaaaaaaaaaaaaaaaaaaaaaaaaaaaaaaaaaaaaaaaaaaaa
"}
